-                                -
-                                -
-                 -  * -*-*-*-*--
-                                -
-             -                  -
-                 -              -
-                                -
-                      -         -
-          -    -   -            -
-                                -
-                                -
-     -                          -
-           -                    -
-                                -
-                                -
-      -                         -
-              -                 -
-                                -
-                                -
-         -                      -
-                                -
-   -P                           -
-                                -
##########################################################################