-                                                                                                                                              - 
-                                                                                                                                              -   
-                                                                                                                                              - 
-                                                                        -                                                                   P - 
-                                                                               -    ----------------------------------------------------------- 
-                                                                    -                                                                         - 
-                                                     -     -                                                                                  - 
-                                                                                                                                              - 
-                                               -                                                                                              - 
-                                        -                                                                                                     - 
-                         -      -                                                                                                             -     
-                  -             -                                                                                                             - 
-                                - -                                                                                                           - 
-            -                   -    -                                                                                                        - 
-         -                      -      -                                                                                                      - 
-      -                         -         -                                                                                                   - 
-                                -                                                                                                             - 
-------------------------------------------------------------------------------------------------------------------------------------------------
------------------------------------------------------------------------------------------------------------------------------------------------- 
-------------------------------------------------------------------------------------------------------------------------------------------------  
-------------------------------------------------------------------------------------------------------------------------------------------------  
-------------------------------------------------------------------------------------------------------------------------------------------------  
-------------------------------------------------------------------------------------------------------------------------------------------------  