-                                - 
-                                -
-                                -
-                                -
-                                -
-                                -
-                              P -
-                            -----
-                          - ****-
-                          *     -
-                        -       -
-                        *       -
-                     -          -
-                     *          -
-                  -             -
-               -  *             -
-               *                -
-           -                    -
-           *                    -
-        -                       -
-        *                       -
-    	P                        -
--   *                           -
##################################