                                  
-                                -
-                                -
-                                -
-                                -
-                                -
-                                -
-                                -
-                                -
-                                -
-                                -
-                                -
-                                -
-                                -
-                                -
-                                -
-                                -
-                                -
-                                -
-                                -
-                                -
-                            P   -
----------------------------------
##################################